. . . . . . . . .
. . . . . . . . .
. . . W . . . . .
. . . . . . . . .
. . . . . . . . .
P . . . W . . . .
. . . G . . . . .
. . P . . . . . .
. . . . . . . . .