. . . . . . . . . . .
. . . . . . . . . . .
. . . . . . . . . . .
. . . . . . . P . . .
. . . W . . . . . . .
G . . . . . . . . . .
. . . . . . . . . . .
. . . W . . P . . . .
. . . . . . . . . . .
. . . . . . . . . P .
. . . . W . . . . . .