. . . . . . . . .
. P . . . . . . .
. . W . . . . . .
G . . . . . . . .
. . . . . . . . .
. P . . . . . . .
. . W . . . . . .
. . . . G . . . .