. . . . . . . . . .
. . . . . . . . . .
. . . . . . . . . .
. . . . W . . . . .
. P . . . . G . . .
. . . . . . . . . .
. . P . W . . . . .
. . . . . . . . P .
. . . . . . . . . .
. . . . . . . . . .